##########
#P   .   #
#   ###  #
#   #L#  #
#   # #  #
#      E #
##########
