[
            {
                "name": "Tutorial",
                "grid": [
                    "##########",
                    "#P      E#",
                    "##########"
                ]
            },
            {
                "name": "First Challenge",
                "grid": [
                    "###########",
                    "#P        #",
                    "#  ###    #",
                    "#  #L#    #",
                    "#  ###   E#",
                    "###########"
                ]
            },
            {
                "name": "Lava Flow",
                "grid": [
                    "###################",
                    "###################",
                    "###################",
                    "#            ######",
                    "#P               E#",
                    "#            ######",
                    "#            #    #",
                    "##           #  L #",
                    "###L         #    #",
                    "###################"
                ]
            },
            {
                "name": "The Maze",
                "grid": [
                    "################",
                    "#P  #          #",
                    "# # # ####### ##",
                    "# #   #     #  #",
                    "# ######### ## #",
                    "#        L    E#",
                    "################"
                ]
            },
            {
                "name": "Water World",
                "grid": [
                    "################",
                    "#P     W  W    #",
                    "# #### W  W  # #",
                    "# # L# W  W  # #",
                    "# #### WWWW  # #",
                    "#             E#",
                    "################"
                ]
            },
            {
                "name": "The Trap",
                "grid": [
                    "##################",
                    "#P               #",
                    "# #######  ##### #",
                    "# #     #  #   # #",
                    "# # L L #  #   # #",
                    "# #     #  ##### #",
                    "# #######        #",
                    "#               E#",
                    "##################"
                ]
            },
            {
                "name": "Water Barrier",
                "grid": [
                    "##################",
                    "#P   L   L   L   #",
                    "#    L   L   L   #",
                    "#   WWWWWWWWWW   #",
                    "#                #",
                    "#    ##    ##   E#",
                    "##################"
                ]
            },
            {
                "name": "The Gauntlet",
                "grid": [
                    "####################",
                    "#P                 #",
                    "#   L   L   L   L  #",
                    "#                  #",
                    "#      WWWW        #",
                    "#      W  W        #",
                    "#   L  WWWW  L    E#",
                    "####################"
                ]
            }
]