[
            {
                "name": "Tutorial",
                "grid": [
                    "###################",
                    "###################",
                    "###################",
                    "#            ######",
                    "#P               E#",
                    "#            ######",
                    "#            #    #",
                    "##           #  L #",
                    "###L         #    #",
                    "###################"
                ]
            },
            {
                "name": "First Challenge",
                "grid": [
                    "################",
                    "#L  #        E #",
                    "#L  ##         #",
                    "#L          ####",
                    "#L  ##   B     #",
                    "#L  #       ## #",
                    "#L  # B      # #",
                    "#L  #        # #",
                    "#L  # P      # #",
                    "#L  #        #L#",
                    "################"
                ]
            },
            {
                "name": "Box and Portals",
                "grid": [
                    "###################",
                    "#               ###",
                    "# #B#########     #",
                    "# #  #      #     #",
                    "# #  #  P   #     #",
                    "# #E #      #     #",
                    "# ####  B   ####B##",
                    "# #L #            #",
                    "# ## ############ #",
                    "#               #L#",
                    "###################"
                ]
            },
            {
                "name": "Water World",
                "grid": [
                    "################",
                    "#             W#",
                    "#            E #",
                    "#              #",
                    "#              #",
                    "# P            #",
                    "#L             #",
                    "################"
                ]
            },
            {
                "name": "Aqua Barrage",
                "grid": [
                    "##################",
                    "#             L  #",
                    "#       ##########",
                    "#              #E#",
                    "#                #",
                    "#                #",
                    "#                #",
                    "#     B          #",
                    "#   ##W##        #",
                    "# P #WWW#        #",
                    "#   #WWW#        #",
                    "##################"
                ]
            },
            {
                "name": "Portal Keys",
                "grid": [
                    "###############",
                    "#L          #W#",
                    "######## P  ###",
                    "#L#      B    #",
                    "# #           #",
                    "# #K     B  E #",
                    "# #           #",
                    "# #           #",
                    "# #######   ###",
                    "#           #W#",
                    "###############"
                ]
            },
            {
                "name": "The Gauntlet",
                "grid": [
                    "###################",
                    "#       E       ###",
                    "# K              ##",
                    "#                 #",
                    "#       B         #",
                    "#P     BWB       L#",
                    "#       B         #",
                    "#                 #",
                    "# K              ##",
                    "#               ###",
                    "###################"
                ]
            },
            {
                "name": "The 3 floods",
                "grid": [
                    "#################",
                    "#L   #WW#      K#",
                    "#    ####       #",
                    "#          B    #",
                    "#########   P   #",
                    "#LL        B   E#",
                    "#########       #",
                    "#          B    #",
                    "# #######       #",
                    "#      L#      K#",
                    "#################"
                ]
            },
             {
                "name": "The great wall",
                "grid": [
                    "################",
                    "#              #",
                    "# #####  ##### #",
                    "#    LB  BL    #",
                    "##B####  ####B##",
                    "#  ####  ####  #",
                    "#K #  #P #  # E#",
                    "#### B    B ####",
                    "#  #        #  #",
                    "#W #        # W#",
                    "################"
                ]
            },
                {
                "name": "The temporary walls",
                "grid": [
                    "################",
                    "#W #           #",
                    "#  #    B    K #",
                    "####           #",
                    "#     #####  ###",
                    "# E P TL#LT  ###",
                    "#     #####  ###",
                    "####           #",
                    "#  #    B    K #",
                    "#W #           #",
                    "################"
                ],
                "temp_walls":[
                    {"position": [6,5], "duration": 30},
                    {"position": [10,5], "duration": 14}
                ]
            },
            {
                "name": "fire fighting",
                "grid": [
                    "################",
                    "#W#          #K#",
                    "###          #T#",
                    "#              #",
                    "#     #T#T#T#  #",
                    "# P B #L#L#L# E#",
                    "#     #T#T#T#  #",
                    "#              #",
                    "###          #T#",
                    "#W#          #K#",
                    "################"
                ],
                "temp_walls":[
                    {"position": [7,4], "duration": 14},
                    {"position": [9,4], "duration": 24},
                    {"position": [11,4], "duration": 46},
                    {"position": [7,6], "duration": 12},
                    {"position": [9,6], "duration": 26},
                    {"position": [11,6], "duration": 48},

                    {"position": [14,2], "duration": 50},
                    {"position": [14,8], "duration": 50}
                ]
            },
            {
                "name": "fire fighting",
                "grid": [
                    "################",
                    "#      #K     K#",
                    "#      #       #",
                    "#   E  #     #T#",
                    "#     #L#    #L#",
                    "# B P TTT   B T#",
                    "#     #W#    #W#",
                    "#      T#    ###",
                    "#       #    TL#",
                    "#      ##K   TL#",
                    "################"
                ],
                "temp_walls":[
                    {"position": [6,5], "duration": 15},
                    {"position": [7,5], "duration": 15},
                    {"position": [8,5], "duration": 15},

                    {"position": [7,7], "duration": 11},

                    {"position": [14,5], "duration": 34},
                    {"position": [14,3], "duration": 32},

                    {"position": [13,8], "duration": 40},
                    {"position": [13,9], "duration": 40}
                ]
            }
]