[
            {
                "name": "Tutorial",
                "grid": [
                    "##########",
                    "#P      E#",
                    "##########"
                ]
            },
            {
                "name": "First Challenge",
                "grid": [
                    "###########",
                    "#P     B  #",
                    "#  ###    #",
                    "#  #L#    #",
                    "#  ###   E#",
                    "###########"
                ]
            },
            {
                "name": "Lava Flow",
                "grid": [
                    "###################",
                    "###################",
                    "###################",
                    "#            ######",
                    "#P               E#",
                    "#            ######",
                    "#            #    #",
                    "##           #  L #",
                    "###L         #    #",
                    "###################"
                ]
            },
            {
                "name": "The Maze",
                "grid": [
                    "################",
                    "#L  #        E #",
                    "#L  ##         #",
                    "#L          ####",
                    "#L  ##   B     #",
                    "#L  #       ## #",
                    "#L  # B      # #",
                    "#L  #        # #",
                    "#L  # P      # #",
                    "#L  #        #L#",
                    "################"
                ]
            },
            {
                "name": "Box and Portals",
                "grid": [
                    "###################",
                    "#               ###",
                    "# #B#########     #",
                    "# #  #      #     #",
                    "# #  #  P   #     #",
                    "# #E #      #     #",
                    "# ####  B   ####B##",
                    "# #L #            #",
                    "# ## ############ #",
                    "#               #L#",
                    "###################"
                ]
            },
            {
                "name": "Water World",
                "grid": [
                    "################",
                    "#P     W  W    #",
                    "# #### W  W  # #",
                    "# # L# W  W  # #",
                    "# #### WWWW  # #",
                    "#             E#",
                    "################"
                ]
            },
            {
                "name": "The Trap",
                "grid": [
                    "##################",
                    "#P               #",
                    "# #######  ##### #",
                    "# #     #  #   # #",
                    "# # L L #  #   # #",
                    "# #     #  ##### #",
                    "# #######        #",
                    "#               E#",
                    "##################"
                ]
            },
            {
                "name": "Water Barrier",
                "grid": [
                    "##################",
                    "#P   L   L   L   #",
                    "#    L   L   L   #",
                    "#   WWWWWWWWWW   #",
                    "#                #",
                    "#    ##    ##   E#",
                    "##################"
                ]
            },
            {
                "name": "The Gauntlet",
                "grid": [
                    "####################",
                    "#P                 #",
                    "#   L   L   L   L  #",
                    "#                  #",
                    "#      WWWW        #",
                    "#      W  W        #",
                    "#   L  WWWW  L    E#",
                    "####################"
                ]
            }
]